border_size=1
usage=map

Rrc, Rrc, Rrc, Rrc, Rrc, Rrc, Rrc, Rrc, Rrc, Rrc, Rrc, Rrc
Rrc, Rrc, Rrc, Rrc, Rrc, Rrc, Rrc, Rrc, Rrc, Rrc, Rrc, Rrc
Rrc, Rrc, Rrc, Rr^Vhc, Rrc, Rrc, Ch, Rrc, Rrc, Rr^Vhc, Rrc, Rrc
Rrc, Rrc, Rrc, Rrc, Ch, Ch, 2 Kh, Ch, Ch, Rrc, Rrc, Rrc
Rrc, Rrc, Rrc, Rrc, Ch, Ch, Ch, Ch, Ch, Rrc, Rrc, Rrc
Rrc, Rrc, Rrc, Rrc, Rrc, Ch, Ch, Ch, Rrc, Rrc, Rrc, Rrc
Rrc, Rrc, Rrc, Rr^Vhc, Rrc, Rrc, Rrc, Rrc, Rrc, Rr^Vhc, Rrc, Rrc
Rrc, Rrc, Rrc, Rrc, Rrc, Rrc, Ch, Rrc, Rrc, Rrc, Rrc, Rrc
Rrc, Rrc, Rrc, Rrc, Rrc, Ch, 1 Kh, Ch, Rrc, Rrc, Rrc, Rrc
Rrc, Rrc, Rrc, Rrc, Rrc, Rrc, Rrc, Rrc, Rrc, Rrc, Rrc, Rrc
Rrc, Rrc, Rrc, Rrc, Rrc, Rrc, Rrc, Rrc, Rrc, Rrc, Rrc, Rrc
