border_size=1
usage=map

Rr, Rr, Rrc, Rr, Rrc, Rr, Rr, Rr, Rr, Rr, Rr, Rr, Rr, Rr, Rr, Rr, Rr
Rr, Rr, Rr, Rrc, Rrc, Rrc, Rrc, Rr, Rr^Vhc, Rr, Rr, Rr, Rr, Rr, Rr, Rr, Rr
Rr, Rr, Rr, Rr, Rr, Rrc, Rrc, Rrc, Rrc, Rr, Rr^Vhc, Rr, Rr, Rr, Rr, Rr^Vhc, Rrc
Rr, Rr, Rr, Rr, Ce, Rr, Rr, Rrc, Rrc, Rrc, Rrc, Rr, Rr, Rr^Vhc, Rrc, Rrc, Rrc
Rr, Rr, Rr, Ce, Ke, Ce, Rr, Rr, Rr^Vhc, Rrc, Rrc, Rrc, Rrc, Rrc, Rrc, Rrc, Rr
Rr, Rr, Rr, Ce, Ce, Ce, Rr, Rr, Rr, Rr, Rrc, Rrc, Rrc, Rrc, Rrc, Rr, Rr
Rr, Rr, Rr, Rr, Rr, Rr, Rr^Vhc, Rr, Rrc, Rrc, Rrc, Rrc, Rr, Rrc, Rrc, Rrc, Rrc
Rr, Rr, Rr, Rr, 1 Rr, Rr, Rrc, Rrc, Rrc, Rrc, Rr^Vhc, Rr, Rr, Rr^Vhc, Rr, Rrc, Rrc
Rr, Rr, Rr, Rr^Vhc, Rrc, Rrc, Rrc, Rrc, Rr^Vhc, Rr, Rr, Rr, Rr, Rr, Rr, Rr^Vhc, Rr
Rr, Rr, Rrc, Rrc, Rrc, Rrc, Rr, Rr, Rr, Rr, Rr, Rr, Rr, Rr, Rr, Rr, Rr
Rrc, Rrc, Rrc, Rrc, Rr, Rr^Vhc, Rr, Rr, Rr, Rr, Rr, Rr, Rr, Rr, Rr, Rr, Rr
Rrc, Rrc, Rr, Rr, Rr, Rr, Rr, Rr, Rr, Rr, Rr, Rr, Rr, Rr, Rr, Rr, Rr
Rr, Rr, Rr, Rr, Rr, Rr, Rr, Rr, Rr, Rr, Rr, Rr, Rr, Rr, Rr, Rr, Rr
Rr, Rr, Rr, Rr, Rr, Rr, Rr, Rr, Rr, Rr, Rr, Rr, Rr, Rr, Rr, Rr, Rr
Rr, Rr, Rr, Rr, Rr, Rr, Rr, Rr, Rr, Rr, Rr, Rr, Rr, Rr, Rr, Rr, Rr
Rr, Rr, Rr, Rr, Rr, Rr, Rr, Rr, Rr, Rr, Rr, Rr, Rr, Rr, Rr, Rr, Rr
Rr, Rr, Rr, Rr, Rr, Rr, Rr, Rr, Rr, Rr, Rr, Rr, Rr, Rr, Rr, Rr, Rr
