border_size=1
usage=map

Hh^Fp, Hh^Fp, Hh^Fds, Mm, Mm, Mm, Mm, Mm, Mm^Xm, Mm^Xm, Mm^Xm, Mm, Mm, Rp, Mm, Mm, Mm^Xm, Mm^Xm, Mm, Mm, Mm, Hh^Fds, Hh^Fds, Hh^Fds
Hh^Fp, Hh^Fp, Hh^Fds, Hh^Fds, Mm, Mm, Mm, Mm, Mm, Mm, Mm, Mm, Mm, Rp, Mm, Mm, Mm, Mm^Xm, Mm, Mm, Mm, Hh^Fds, Gg, Gg
Hh^Fp, Hh^Fp, Mm, Mm, Mm, Mm, Mm, Mm, Mm, Mm, Mm, Mm, Hh^Fds, Rp, Mm, Mm, Mm, Mm, Mm, Mm, Mm, Gg, Gg, Gg
Hh^Fp, Hh^Fp, Mm, Mm, Mm, Mm, Mm^Xm, Mm, Mm, Mm, Mm, Mm, Wwg, Wwg^Bw|r, Wwg, Mm, Hh^Fp, Mm, Hh^Fp, Hh, Gg, Gg, Ss, Gg
Hh^Fp, Hh^Fp, Hh^Fp, Mm, Mm, Mm^Xm, Mm^Xm, Mm^Xm, Wwf, Wwf, Wwg, Wwg, Hh^Fds, Rp, Hh^Fds, Wwg, Wwg, Hh^Fp, Wwg, Gs^Vh, Gs^Fds, Ss, Wwg, Wwg
Hh^Fp, Hh^Fp, Mm, Mm, Mm, Mm^Xm, Mm^Xm, Wwf, Mm^Xm, Mm, Mm, Mm, Mm, Rp, Mm, Hh^Fds, Hh^Fp, Wwg, Hh^Fp, Wwg, Wwg, Wwg, Ww^Ewf, Wwg
Hh^Fp, Hh^Fp, Hh^Fds, Mm, Mm, Mm^Xm, Mm^Xm, Mm^Xm, Mm, Mm, Mm, Gs^Vl, Mm, Rp, Mm, Mm, Mm, Hh^Fp, Mm, Hh, Gs^Fds, Ww^Ewf, Gg^Fet, Ww^Ewf
Hh^Fp, Hh^Fp, Hh^Fds, Hh^Fds, Hh^Fds, Mm, Mm, Mm, Mm, Mm, Mm, Mm, Mm, Rp, Mm, Mm, Mm, Mm, Mm, Hh, Hh^Fds, Gs^Vh, Gg, Gg
Hh^Fp, Hh^Fp, Hh^Fds, Hh^Fds, Mm, Mm, Mm, Mm, Mm, Mm, Mm, Mm, Mm, Rp, Mm, Mm, Mm, Mm, Mm, Mm, Mm, Gg, Gg, Gg
Hh^Fp, Hh^Fp, Hh^Fds, Mm, Mm, Mm, Mm^Xm, Mm, Mm^Xm, Mm, Mm, Mm, Mm, Rp, Mm, Mm, Mm, Mm, Mm, Mm, Mm, Hh, Hh, Hh^Fds
Hh^Fp, Hh^Fp, Mm, Mm, Mm^Xm, Mm^Xm, Mm^Xm, Mm^Xm, Mm^Xm, Mm^Xm, Mm, Mm, Mm, Rp, Mm, Mm, Mm, Mm, Mm, Mm, Mm, Hh, Hh, Hh
Hh^Fp, Hh^Fp, Hh^Fds, Mm^Xm, Mm^Xm, Mm^Xm, Mm^Xm, Mm^Xm, Mm^Xm, Mm^Xm, Mm^Xm, Mm^Xm, Mm^Xm, Rp, Mm^Xm, Mm, Mm^Xm, Mm^Xm, Mm^Xm, Mm, Mm, Hh, Hh, Hh
Hh^Fp, Hh^Fp, Mm, Mm, Mm, Mm, Mm, Mm, Mm, Mm, Mm, Mm^Xm, Rp, Rp, Mm^Xm, Mm^Xm, Mm^Xm, Mm^Xm, Mm^Xm, Mm^Xm, Hh^Fp, Hh, Hh^Fp, Hh
Hh^Fms, Hh^Fms, Hh^Fms, Mm, Mm, Mm, Mm, Mm, Mm, Hh^Vhh, Ch, Ch, Ch, Mm^Xm, Mm, Mm^Xm, Mm, Mm, Mm, Hh^Fp, Hh^Fp, Hh^Fp, Hh^Fp, Hh^Fp
Hh^Fms, Hh^Fms, Hh^Fms, Mm, Hh^Fms, Mm, Mm, Mm, Mm, Mm, Ch, 1 Kh, Ch, Mm, Mm, Mm, Mm, Mm, Hh^Fp, Hh^Fp, Hh^Fp, Hh^Fp, Hh^Fp, Hh^Fp
Hh^Fms, Hh^Fms, Hh^Fp, Hh^Fms, Hh^Fms, Hh^Fms, Hh^Fds, Mm, Mm, Mm, Hh^Fds, Ch, Hh^Fds, Mm, Mm, Mm, Hh^Fds, Hh^Fms, Hh^Fp, Hh^Fp, Hh^Fms, Hh^Fms, Hh^Fms, Hh^Fms
Hh^Fms, Hh^Fms, Hh^Fp, Hh^Fms, Hh^Fms, Hh^Fms, Hh^Fds, Hh^Fds, Hh^Fds, Hh^Fds, Gs^Fms, Rp, Gs^Fds, Hh^Fds, Hh^Fds, Hh^Fds, Gg^Fet, Hh^Fms, Hh^Fms, Hh^Fp, Hh^Fms, Hh^Fms, Hh^Fms, Hh^Fms
Hh^Fms, Hh^Fms, Hh^Fms, Hh^Vhh, Hh^Fms, Hh^Fms, Hh^Fms, Hh^Fds, Hh^Fds, Hh^Fds, Hh^Fms, Rp, Hh^Fms, Hh^Fms, Hh^Fms, Hh^Vhh, Hh^Fms, Hh^Fds, Hh^Fms, Hh^Fms, Hh^Fds, Hh^Fms, Hh^Fds, Hh^Fms
Hh^Fms, Hh^Fms, Hh^Fms, Hh^Fms, Hh^Fds, Hh^Fms, Hh^Fms, Hh^Fms, Hh^Fms, Hh^Fms, Hh^Fms, Rp, Hh^Fms, Hh^Fms, Hh^Fms, Hh^Fms, Hh^Fms, Hh^Fms, Hh^Fms, Hh^Fds, Hh^Fms, Hh^Fds, Hh^Fms, Hh^Fms
Hh^Fms, Hh^Fds, Hh^Fds, Hh^Fms, Hh^Fms, Hh^Fms, Hh^Fms, Hh^Fms, Gs, Gs, Hh^Fms, Rp, Gs, Hh^Fms, Hh^Fp, Gg^Fet, Gg^Fet, Gs^Fms, Gs^Fms, Hh^Fms, Gs^Fms, Hh^Fms, Hh^Fms, Hh^Fms
Hh^Fds, Hh^Fds, Hh^Fms, Hh^Fms, Hh^Fms, Hh^Fms, Hh^Fms, Hh^Fms, Gs, Gs, Gs, Rp, Gs, Gs, Gs, Gs^Fms, Gs^Fms, Gs^Fms, Gs, Hh^Vhh, Gs, Hh^Fms, Hh^Fds, Hh^Fms
Hh^Fds, Hh^Fds, Hh^Fms, Hh^Fms, Hh^Fms, Hh^Fms, Gs^Fms, Gs, Gs, Gs, Gs, Rp, Gs, Gs, Gs, Gs, Gs, Gs, Gs, Gs, Gs, Hh^Fms, Hh^Fms, Hh^Fms
Hh^Fds, Hh^Fms, Hh^Fms, Gg^Fet, Gs, Gs, Gs, Gs, Gs, Gs, Gs, Rp, Gs, Gs, Gs, Gs, Ce, Ce, Ce, Gs, Gs, Gs, Gs, Gs
Hh^Fms, Hh^Fms, Hh^Fms, Gs, Gs, Gs, Gs, Gs, Gs, Gs, Gs, Rp, Urb, Gs, Gs, Gs, Ce, 2 Ke, Ce, Gs, Gs, Gs, Urb, Urb
Gs^Fms, Hh^Fms, Hh^Vhh, Gs, Gs, Gs, Gs, Gs, Gs, Gs, Urb, Urb, Urb, Urb, Urb, Gs, Gs, Ce, Gs, Gs, Urb, Urb, Urb, Urb
Gs^Fms, Gs^Fms, Gs, Gs, Gs, Gs, Gs, Gs, Urb, Urb, Urb, Urb, Gs, Urb, Urb, Urb, Urb, Gs, Urb, Urb, Urb, Urb, Gs, Gs
Gs^Fms, Gs^Fms, Gs^Fms, Gs, Gs, Gs, Urb, Urb, Urb, Urb, Gs, Gs, Gs, Gs, Gs, Urb, Urb, Urb, Urb, Urb, Gs, Gs, Gs, Gs
Gs^Fms, Gs, Gs, Gs, Urb, Urb, Urb, Urb, Gs, Gs, Gs, Gs, Gs, Gs, Gs, Gs, Gs, Urb, Gs, Gs, Gs, Gs, Gs, Gs
Gs^Fms, Gs, Urb, Urb, Urb, Urb, Gs^Fms, Gs^Fms, Gs, Gs, Gs, Gs, Gs, Gs, Gs, Gs, Gs, Gs, Gs, Gs, Gs, Gs, Gs, Gs
Urb, Urb, Gs, Urb, Gs, Gs^Fms, Gs, Gs, Gs, Gs, Gs, Gs, Gs, Gs, Gs, Gs, Gs, Gs, Gs, Gs, Gs, Gs, Gs, Gs
