border_size=1
usage=map

Xu, Xu, Xu, Xu, Xu, Xu, Xu, Xu, Xu, Xu, Xu, Xu, Xu, Xu, Xu, Xu, Xu, Xu, Xu, Xu
Xu, Xu, Xu, Xu, Xu, Xu, Xu, Xu, Xu, Xu, Xu, Xu, Xu, Xu, Xu, Xu, Xu, Xu, Xu, Xu
Xu, Xu, Xu, Xu, Xu, Uu^Vu, Xu, Xu, Uh, Xu, Qxu, Xu, Uu, Uh, Uu, Uu^Vu, Xu, Xu, Xu, Xu
Xu, Uh, Uu, Xu, Uu, Uu, Uu, Uh, Uu, Uu, Qxu, Qxu, Uu, Ql, Ql, Uu, Uu, Xu, Xu, Xu
Xu, Uh, Uu, Uu, Qxu, Uu, Uu, Uu, Uu, Qxu, Qxu, Qxu, Uu, Ql, Uu, Uu, Qxu, Uu, Uh, Xu
Xu, Xu, Uu, Uu, Qxu, Qxu, Uu, Uu, Uu, Uu, Uu, Uu, Uu, Uu, Uu, Qxu, Qxu, Uu, Uu, Xu
Xu, Xu, Uu, Qxu, Uu, Uu, Ql, Ql, Ql, Ql, Ql, Qxu, Uu, Uu, Uu, Qxu, Uu, Uu, Xu, Xu
Xu, Uh, Ql, Uu, Ql, Uu, Qxu^Bs\, Ql, Uu^Vu, Ql, Qxu^Bs/, Uu, Ql, Uu, Qxu, Uu, Uu, Uu, Uu, Xu
Xu, Uh, Ql, Uu, Ql, Ql, Urb, Urb, Cud, Urb, Urb, Ql, Ql, Ql, Uu, Uu, Ql, Uu, Uu, Xu
Xu, Uu, Uu, Uu, Ql, Urb, Cud, Cud, 2 Kud^Ii, Cud, Cud, Urb, Ql, Ql, Uu, Uu, Ql, Ql, Uu, Xu
Xu, Xu, Uu, Uu, Ql, Uu^Vu, Cud, Cud, Cud, Cud, Cud, Uu^Vu, Ql, Uu, Uu, Uu, Uu, Uu, Uu, Xu
Xu, Xu, Uu, Uu, Ql, Urb, Urb, Cud, Cud, Cud, Urb, Urb, Ql, Uu, Uu, Qxu, Qxu, Uu, Uu, Xu
Xu, Uh, Uh, Uu, Ql, Ql, Qxu^Bs/, Urb, Uu^Vu, Urb, Qxu^Bs\, Ql, Ql, Uu, Uu, Qxu, Uu, Uu, Uh, Xu
Xu, Xu, Qxu, Uu, Uu, Uu, Uu, Ql, Ql, Ql, Ql, Uu, Uu, Uu, Ql, Uu, Uu, Uu, Xu, Xu
Xu, Xu, Qxu, Qxu, Qxu, Uu, Uu, Ql, Ql, Ql, Uu, Uu, Uu, Uu, Uu, Uu, Uh, Xu, Xu, Xu
Xu, Xu, Xu, Qxu, Qxu, Uh, Uu, Uu, Uu, Uu, Qxu, Qxu, Qxu, Uu, Uh, Uh, Xu, Uu^Vu, Xu, Xu
Xu, Xu, Xu, Xu, Uu^Vu, Uh, Uu, Uu, 1 Uu, Uu, Uu, Qxu, Uu, Uu, Xu, Xu, Xu, Xu, Xu, Xu
Xu, Xu, Xu, Xu, Xu, Xu, Xu, Uu, Uu, Uu, Xu, Xu, Xu, Xu, Xu, Xu, Xu, Xu, Xu, Xu
